81
########################
#@..............ac.GI.b#
###d#e#f################
###A#B#C################
###g#h#i################
########################