86
########################
#f.D.E.e.C.b.A.@.a.B.c.#
######################.#
#d.....................#
########################